#地图大小: 地图宽度x地图高度
map_size=30x20

#玩家数量
players=5

#电脑数量： 格式为 类型:数量，用逗号分隔
computers=tank05:40,tank06:10

#初始电脑数量
computer_start=6


#地图布局
#0：空 1：砖 2：铁 3：河 4：草
#K：玩家基地 P：玩家出生点 E：电脑出生点 C：电脑基地

map_content=
E0441000000001110000000010440E
024411111000333330001111104420
001010000000111110000000100000
001330011000004000001100033000
001330010000004000000100033000
001000030000444440000300000000
000000030000022200000300000000
00422103004000P000400300122400
434110040041011101400400011434
434114440041P1K1P1400444011434
434110040041011101400400011434
00422103004000P000400300122400
000000030000022200000300000000
000000030000444440000300000000
001000010000004000000100000000
001330011000004000001100033000
001330000000111110000000033000
001010000000333330000000100000
024411111000111110001111104420
E0441000000001110000000010440E
